XXXXXXXXXXXXXXXXXXXXXXXX
XM1      B     X  B  X X
XXX   X      X MX  XXX X
XXX XXXXXXXX X  X      X
X   X    X   X  XXXXXX X
X   X  XXX   X       X X
X   X      M   XXXX  X X
X XXX XXXXXX   2  X    X
X X   X    X  X   XXXXXX
X XXXXX  X XXXXX       X
X B      X   B   X   X X
XXXXXXXXXXXXXXXXXXXXXXXX